NO ./textures/wall_n.xpm
SO ./textures/wall_s.xpm
WE ./textures/wall_w.xpm
EA ./textures/wall_e.xpm

F 220,100,10
C 225,30,0

11111111111111
11000011000001
10000000000011
11000N00000001
11000000000001
11111111111111